4 2 2 2 2 2 2 2 2 2 2 2 2 2 2 2 2 2 2 2 5 0 4 2 2 2 2 2 2 2 2 2 2 2 2 2 2 2 2 2 2 2 5
3 8 1 1 1 1 1 1 1 1 1 1 1 1 1 1 1 1 1 1 3 0 3 1 1 1 1 1 1 1 1 1 1 1 1 1 1 1 1 1 1 8 3
3 1 4 2 2 2 2 2 5 1 4 2 2 2 2 2 2 2 5 1 3 0 3 1 4 2 2 2 2 2 2 2 5 1 4 2 2 2 2 2 5 1 3
3 1 3 0 0 0 0 0 3 1 3 0 0 0 0 0 0 0 3 1 3 0 3 1 3 0 0 0 0 0 0 0 3 1 3 0 0 0 0 0 3 1 3
3 1 6 2 2 2 2 2 7 1 6 2 2 2 2 2 2 2 7 1 6 2 7 1 6 2 2 2 2 2 2 2 7 1 6 2 2 2 2 2 7 1 3
3 1 1 1 1 1 1 1 9 0 1 1 1 1 1 1 1 1 1 0 1 1 1 0 1 1 1 1 1 1 1 1 1 0 1 1 1 1 1 1 1 1 3
3 1 4 2 2 2 2 2 5 1 4 2 5 1 4 2 2 2 2 2 2 2 2 2 2 2 2 2 5 1 4 2 5 1 4 2 2 2 2 2 5 1 3
3 1 6 2 2 2 2 2 7 1 3 0 3 1 6 2 2 2 2 5 0 0 0 4 2 2 2 2 7 1 3 0 3 1 6 2 2 2 2 2 7 1 3
3 1 1 1 1 1 1 1 1 1 3 0 3 1 1 1 1 1 1 3 0 0 0 3 1 1 1 1 1 1 3 0 3 1 1 1 1 1 1 1 1 1 3
6 2 2 2 2 2 2 2 5 1 3 0 6 2 2 2 2 5 1 3 0 0 0 3 1 4 2 2 2 2 7 0 3 1 4 2 2 2 2 2 2 2 7
0 0 0 0 0 0 0 0 3 1 3 0 4 2 2 2 2 7 1 6 2 2 2 7 1 6 2 2 2 2 5 0 3 1 3 0 0 0 0 0 0 0 0
0 0 0 0 0 0 0 0 3 1 3 0 3 1 1 1 1 1 1 1 1 1 1 1 1 1 1 1 1 1 3 0 3 1 3 0 0 0 0 0 0 0 0
2 2 2 2 2 2 2 2 7 1 6 2 7 1 4 2 2 2 2 2 2 0 2 2 2 2 2 2 5 1 6 2 7 1 6 2 2 2 2 2 2 2 2
1 1 1 1 9 1 1 1 1 0 1 1 1 1 3 0 0 0 0 0 0 0 0 0 0 0 0 0 3 1 1 1 1 0 1 1 1 1 1 1 1 1 1
2 2 2 2 2 2 2 2 5 1 4 2 5 1 6 2 2 2 2 2 2 2 2 2 2 2 2 2 7 1 4 2 5 1 4 2 2 2 2 2 2 2 2
0 0 0 0 0 0 0 0 3 1 3 0 3 1 1 1 1 1 1 1 1 1 1 1 1 1 1 1 1 1 3 0 3 1 3 0 0 0 0 0 0 0 0
0 0 0 0 0 0 0 0 3 1 3 0 3 1 4 2 2 2 2 2 2 2 2 2 2 2 2 2 5 1 3 0 3 1 3 0 0 0 0 0 0 0 0
4 2 2 2 2 2 2 2 7 1 6 2 7 1 6 2 2 2 2 5 0 0 0 4 2 2 2 2 7 1 6 2 7 1 6 2 2 2 2 2 2 2 5
3 1 1 1 1 1 1 1 1 0 1 1 1 8 1 1 1 1 1 3 0 0 0 3 1 1 1 1 1 0 8 1 1 0 1 1 1 1 1 1 1 1 3
3 1 4 2 2 2 2 2 5 1 4 2 2 2 2 2 2 5 1 3 0 0 0 3 1 4 2 2 2 2 2 2 5 1 4 2 2 2 2 2 5 1 3
3 1 6 2 2 2 5 0 3 1 6 2 2 2 2 2 2 7 1 6 2 2 2 7 1 6 2 2 2 2 2 2 7 1 3 0 4 2 2 2 7 1 3
3 1 1 1 1 1 3 0 3 1 1 1 1 1 1 1 1 1 0 1 1 1 1 1 0 1 1 1 1 1 1 9 1 1 3 0 3 1 1 1 1 1 3
6 2 2 2 5 1 3 0 3 1 4 2 5 1 4 2 2 2 2 2 2 2 2 2 2 2 2 2 5 1 4 2 5 1 3 0 3 1 4 2 2 2 7
4 2 2 2 7 1 6 2 7 1 3 0 3 1 6 2 2 2 2 5 0 0 0 4 2 2 2 2 7 1 3 0 3 1 6 2 7 1 6 2 2 2 5
3 1 1 1 1 1 1 1 1 1 3 0 3 1 1 1 1 1 1 3 0 0 0 3 1 1 1 1 1 1 3 0 3 1 1 1 1 1 1 1 1 1 3
3 1 4 2 2 2 2 2 2 2 7 0 6 2 2 2 2 5 1 3 0 0 0 3 1 4 2 2 2 2 7 0 6 2 2 2 2 2 2 2 5 1 3
3 1 6 2 2 2 2 2 2 2 2 2 2 2 2 2 2 7 1 6 2 2 2 7 1 6 2 2 2 2 2 2 2 2 2 2 2 2 2 2 7 1 3
3 1 1 1 1 1 1 1 1 1 1 1 1 1 1 1 1 1 0 1 1 1 1 1 0 1 1 1 1 1 1 1 1 1 1 1 1 1 1 1 1 1 3
6 2 2 2 2 2 2 2 2 2 2 2 2 2 2 2 2 2 2 2 2 2 2 2 2 2 2 2 2 2 2 2 2 2 2 2 2 2 2 2 2 2 7